30,30,30,30,30,30,30,30,30,30,30,30,30,30,30,30,30,30,30,30
30,30,30,30,30,30,30,30,30,30,30,30,30,30,30,30,30,30,30,30
124,124,124,124,124,124,124,124,124,124,124,124,124,124,124,124,124,124,124,124
124,124,124,124,123,124,123,123,123,124,123,124,123,123,123,124,123,123,124,123
124,124,124,124,124,124,124,124,124,124,124,124,124,124,124,124,124,124,124,124
124,124,124,124,124,124,124,124,124,124,124,124,124,124,124,124,124,124,124,124
124,124,124,124,124,124,124,124,124,124,124,124,124,124,124,124,124,124,124,124
124,124,124,124,124,124,124,124,124,124,124,124,124,124,124,124,124,124,124,124
124,124,124,124,124,124,124,124,124,124,124,124,124,124,124,124,124,124,124,124
124,124,124,124,124,124,124,124,124,124,124,124,124,124,124,124,124,124,124,124
124,124,124,124,124,124,124,124,124,124,124,124,124,124,124,124,124,124,124,124
124,124,124,124,124,124,124,124,124,124,124,124,124,124,124,124,124,124,124,124
124,124,124,124,124,124,124,124,124,124,124,124,124,124,124,124,124,124,124,124
124,124,124,124,124,124,123,124,123,124,123,123,124,124,124,124,124,124,124,124
124,124,124,123,124,123,124,124,124,124,124,124,123,123,123,124,124,124,124,124
